####################################################################
#                                                                  #
#                                                                  #
#        $                                                  O      #
#                                                                  #
##############################         #############################
#                                                                  #
#                                                         $        #
#             $                                                    #
#        ###########################################################
#                                                                  #
#    $                                                       $     #
#                                                                  #
##############################         #############################
#                                                                  #
#                                                                  #
#                                                                  #
#           ########################################################
#                                                                  #
#     $                     $                                      #
#                                                                  #
##########################################                         #
#                                                                  #
#                                                                  #
#                                                                  #
####################################################################