###################################################################
#                                                                 #
#                                                                 #
#                                                           O     #
#        $                                                        #
##############################         ############################
#                                                                 #
#                                                                 #
#                                                        $        #
#        ##########################################################
#                                                                 #
#                                                                 #
#     $                                                     $     #
##############################         ############################
#                                                                 #
#                                                                 #
#                                                                 #
#           #######################################################
#                                                                 #
#                                                                 #
#      $                    $                                     #
##########################################                        #
#                                                                 #
#                                                                 #
#                                                                 #
###################################################################