######################################################################
##                                                        _____     ##
##                                                       |  !  |    ##
##        $                                              |  !  |    ##
##                                                       |  !  |    ##
###############################         ##############################
##                                                                  ##
##                                                         $        ##
##                                                                  ##
##        ############################################################
##                                                                  ##
##    $                                                       $     ##
##                                                                  ##
###############################         ##############################
##                                                                  ##
##                                                                  ##
##                                                                  ##
##           #########################################################
##                                                                  ##
##     $                     $                                      ##
##                                                                  ##
###########################################                         ##
##                                                                  ##
##                                                                  ##
##                                                                  ##
######################################################################